##############################
#..................#.........#
#..................#.........#
#..P...............#.........#
#..................#.........#
############...........#######
#..........#.................#
#..........#.................#
#..........#.................#
#............................#
#................#...........#
#................#...........#
#................#...........#
#######..........#############
#............................#
#.........#..................#
#.........#..................#
#...E.....#..................#
#.........#..................#
##############################
