##############################
#............................#
#............................#
#............................#
#######......................#
#.....#............###########
#.....#......................#
#.....######.................#
#............................#
#..................P.........#
#............$...............#
#.....H......................#
#............................#
#############................#
#............................#
#....................#...E...#
#....................#.......#
#....................#.......#
#....................#.......#
##############################
