##############################
#............................#
#....................P.......#
#............................#
#######......................#
#.H...#..$.........###########
#.....#............#.........#
#.....######.......#.........#
#......X.....................#
#............................#
#............$...............#
#....................#########
#............................#
#############................#
#............................#
#.........$..........#.......#
#....................#.......#
#...E................#....$..#
#....................#.......#
##############################
